1.595340019401075005e-01,1.595340019401075005e-01,1.595340019401075005e-01,1.595340019401075005e-01,1.595340019401075005e-01,1.595340019401075005e-01,1.595340019401075005e-01,1.595340019401075005e-01
1.820370724373631954e-01,1.820370724373631954e-01,1.820370724373631954e-01,1.820370724373631954e-01,1.820370724373631954e-01,1.820370724373631954e-01,1.820370724373631954e-01,1.820370724373631954e-01
1.149289023941518217e-01,1.149289023941518217e-01,1.149289023941518217e-01,1.149289023941518217e-01,1.149289023941518217e-01,1.149289023941518217e-01,1.149289023941518217e-01,1.149289023941518217e-01
5.338253141842024263e-01,5.338253141842024263e-01,5.338253141842024263e-01,5.338253141842024263e-01,5.338253141842024263e-01,5.338253141842024263e-01,5.338253141842024263e-01,5.338253141842024263e-01
8.590292412159605817e-02,8.590292412159605817e-02,8.590292412159605817e-02,8.590292412159605817e-02,8.590292412159605817e-02,8.590292412159605817e-02,8.590292412159605817e-02,8.590292412159605817e-02
1.595340019401068343e-01,1.595340019401068343e-01,1.595340019401068343e-01,1.595340019401068343e-01,1.595340019401068343e-01,1.595340019401068343e-01,1.595340019401068343e-01,1.595340019401068343e-01
7.363107781851052636e-02,7.363107781851052636e-02,7.363107781851052636e-02,7.363107781851052636e-02,7.363107781851052636e-02,7.363107781851052636e-02,7.363107781851052636e-02,7.363107781851052636e-02
6.135923151542570508e-01,6.135923151542570508e-01,6.135923151542570508e-01,6.135923151542570508e-01,6.135923151542570508e-01,6.135923151542570508e-01,6.135923151542570508e-01,6.135923151542570508e-01
1.595340019401075005e-01,1.595340019401075005e-01,1.595340019401075005e-01,1.595340019401075005e-01,1.595340019401075005e-01,1.595340019401075005e-01,1.595340019401075005e-01,1.595340019401075005e-01
