1.455824707178725863e-01,1.455824707178725863e-01,1.455824707178725863e-01,1.455824707178725863e-01,1.455824707178725863e-01,1.455824707178725863e-01,1.455824707178725863e-01,1.455824707178725863e-01
1.656699250916497945e-01,1.656699250916497945e-01,1.656699250916497945e-01,1.656699250916497945e-01,1.656699250916497945e-01,1.656699250916497945e-01,1.656699250916497945e-01,1.656699250916497945e-01
1.227184630308508773e-01,1.227184630308508773e-01,1.227184630308508773e-01,1.227184630308508773e-01,1.227184630308508773e-01,1.227184630308508773e-01,1.227184630308508773e-01,1.227184630308508773e-01
5.583690067903734899e-01,5.583690067903734899e-01,5.583690067903734899e-01,5.583690067903734899e-01,5.583690067903734899e-01,5.583690067903734899e-01,5.583690067903734899e-01,5.583690067903734899e-01
9.156317309933287296e-02,9.156317309933287296e-02,9.156317309933287296e-02,9.156317309933287296e-02,9.156317309933287296e-02,9.156317309933287296e-02,9.156317309933287296e-02,9.156317309933287296e-02
1.619644496821432134e-01,1.619644496821432134e-01,1.619644496821432134e-01,1.619644496821432134e-01,1.619644496821432134e-01,1.619644496821432134e-01,1.619644496821432134e-01,1.619644496821432134e-01
1.165825398793087775e-01,1.165825398793087775e-01,1.165825398793087775e-01,1.165825398793087775e-01,1.165825398793087775e-01,1.165825398793087775e-01,1.165825398793087775e-01,1.165825398793087775e-01
5.583690067903734899e-01,5.583690067903734899e-01,5.583690067903734899e-01,5.583690067903734899e-01,5.583690067903734899e-01,5.583690067903734899e-01,5.583690067903734899e-01,5.583690067903734899e-01
1.455824707178725863e-01,1.455824707178725863e-01,1.455824707178725863e-01,1.455824707178725863e-01,1.455824707178725863e-01,1.455824707178725863e-01,1.455824707178725863e-01,1.455824707178725863e-01
