1.472621556370201368e-01,1.472621556370201368e-01,1.472621556370201368e-01,1.472621556370201368e-01,1.472621556370201368e-01,1.472621556370201368e-01,1.472621556370201368e-01,1.472621556370201368e-01
1.779417713947335777e-01,1.779417713947335777e-01,1.779417713947335777e-01,1.779417713947335777e-01,1.779417713947335777e-01,1.779417713947335777e-01,1.779417713947335777e-01,1.779417713947335777e-01
1.963495408493622640e-01,1.963495408493622640e-01,1.963495408493622640e-01,1.963495408493622640e-01,1.963495408493622640e-01,1.963495408493622640e-01,1.963495408493622640e-01,1.963495408493622640e-01
5.215534678811182268e-01,5.215534678811182268e-01,5.215534678811182268e-01,5.215534678811182268e-01,5.215534678811182268e-01,5.215534678811182268e-01,5.215534678811182268e-01,5.215534678811182268e-01
1.043106935762230236e-01,1.043106935762230236e-01,1.043106935762230236e-01,1.043106935762230236e-01,1.043106935762230236e-01,1.043106935762230236e-01,1.043106935762230236e-01,1.043106935762230236e-01
1.779417713947341884e-01,1.779417713947341884e-01,1.779417713947341884e-01,1.779417713947341884e-01,1.779417713947341884e-01,1.779417713947341884e-01,1.779417713947341884e-01,1.779417713947341884e-01
8.590292412159582225e-02,8.590292412159582225e-02,8.590292412159582225e-02,8.590292412159582225e-02,8.590292412159582225e-02,8.590292412159582225e-02,8.590292412159582225e-02,8.590292412159582225e-02
6.442719309119699922e-01,6.442719309119699922e-01,6.442719309119699922e-01,6.442719309119699922e-01,6.442719309119699922e-01,6.442719309119699922e-01,6.442719309119699922e-01,6.442719309119699922e-01
1.472621556370201368e-01,1.472621556370201368e-01,1.472621556370201368e-01,1.472621556370201368e-01,1.472621556370201368e-01,1.472621556370201368e-01,1.472621556370201368e-01,1.472621556370201368e-01
