1.472621556370210527e-01,1.472621556370210527e-01,1.472621556370210527e-01,1.472621556370210527e-01,1.472621556370210527e-01,1.472621556370210527e-01,1.472621556370210527e-01,1.472621556370210527e-01
1.595340019401075005e-01,1.595340019401075005e-01,1.595340019401075005e-01,1.595340019401075005e-01,1.595340019401075005e-01,1.595340019401075005e-01,1.595340019401075005e-01,1.595340019401075005e-01
1.227184630308519736e-01,1.227184630308519736e-01,1.227184630308519736e-01,1.227184630308519736e-01,1.227184630308519736e-01,1.227184630308519736e-01,1.227184630308519736e-01,1.227184630308519736e-01
5.460971604872891794e-01,5.460971604872891794e-01,5.460971604872891794e-01,5.460971604872891794e-01,5.460971604872891794e-01,5.460971604872891794e-01,5.460971604872891794e-01,5.460971604872891794e-01
9.203884727313837999e-02,9.203884727313837999e-02,9.203884727313837999e-02,9.203884727313837999e-02,9.203884727313837999e-02,9.203884727313837999e-02,9.203884727313837999e-02,9.203884727313837999e-02
1.595340019401068343e-01,1.595340019401068343e-01,1.595340019401068343e-01,1.595340019401068343e-01,1.595340019401068343e-01,1.595340019401068343e-01,1.595340019401068343e-01,1.595340019401068343e-01
7.383071730274612388e-02,7.383071730274612388e-02,7.383071730274612388e-02,7.383071730274612388e-02,7.383071730274612388e-02,7.383071730274612388e-02,7.383071730274612388e-02,7.383071730274612388e-02
6.013204688511716300e-01,6.013204688511716300e-01,6.013204688511716300e-01,6.013204688511716300e-01,6.013204688511716300e-01,6.013204688511716300e-01,6.013204688511716300e-01,6.013204688511716300e-01
1.472621556370210527e-01,1.472621556370210527e-01,1.472621556370210527e-01,1.472621556370210527e-01,1.472621556370210527e-01,1.472621556370210527e-01,1.472621556370210527e-01,1.472621556370210527e-01
