1.533980787885651509e-01,1.533980787885651509e-01,1.533980787885651509e-01,1.533980787885651509e-01,1.533980787885651509e-01,1.533980787885651509e-01,1.533980787885651509e-01,1.533980787885651509e-01
1.656699250916489063e-01,1.656699250916489063e-01,1.656699250916489063e-01,1.656699250916489063e-01,1.656699250916489063e-01,1.656699250916489063e-01,1.656699250916489063e-01,1.656699250916489063e-01
1.472621556370214690e-01,1.472621556370214690e-01,1.472621556370214690e-01,1.472621556370214690e-01,1.472621556370214690e-01,1.472621556370214690e-01,1.472621556370214690e-01,1.472621556370214690e-01
5.338253141842042027e-01,5.338253141842042027e-01,5.338253141842042027e-01,5.338253141842042027e-01,5.338253141842042027e-01,5.338253141842042027e-01,5.338253141842042027e-01,5.338253141842042027e-01
6.749515466696821842e-02,6.749515466696821842e-02,6.749515466696821842e-02,6.749515466696821842e-02,6.749515466696821842e-02,6.749515466696821842e-02,6.749515466696821842e-02,6.749515466696821842e-02
1.595340019401068343e-01,1.595340019401068343e-01,1.595340019401068343e-01,1.595340019401068343e-01,1.595340019401068343e-01,1.595340019401068343e-01,1.595340019401068343e-01,1.595340019401068343e-01
1.043106935762239257e-01,1.043106935762239257e-01,1.043106935762239257e-01,1.043106935762239257e-01,1.043106935762239257e-01,1.043106935762239257e-01,1.043106935762239257e-01,1.043106935762239257e-01
6.074563920027137298e-01,6.074563920027137298e-01,6.074563920027137298e-01,6.074563920027137298e-01,6.074563920027137298e-01,6.074563920027137298e-01,6.074563920027137298e-01,6.074563920027137298e-01
1.533980787885651509e-01,1.533980787885651509e-01,1.533980787885651509e-01,1.533980787885651509e-01,1.533980787885651509e-01,1.533980787885651509e-01,1.533980787885651509e-01,1.533980787885651509e-01
