1.533980787885642627e-01,1.533980787885642627e-01,1.533980787885642627e-01,1.533980787885642627e-01,1.533980787885642627e-01,1.533980787885642627e-01,1.533980787885642627e-01,1.533980787885642627e-01
2.208932334555326615e-01,2.208932334555326615e-01,2.208932334555326615e-01,2.208932334555326615e-01,2.208932334555326615e-01,2.208932334555326615e-01,2.208932334555326615e-01,2.208932334555326615e-01
1.718058482431916723e-01,1.718058482431916723e-01,1.718058482431916723e-01,1.718058482431916723e-01,1.718058482431916723e-01,1.718058482431916723e-01,1.718058482431916723e-01,1.718058482431916723e-01
6.381360077604280034e-01,6.381360077604280034e-01,6.381360077604280034e-01,6.381360077604280034e-01,6.381360077604280034e-01,6.381360077604280034e-01,6.381360077604280034e-01,6.381360077604280034e-01
1.656699250916489063e-01,1.656699250916489063e-01,1.656699250916489063e-01,1.656699250916489063e-01,1.656699250916489063e-01,1.656699250916489063e-01,1.656699250916489063e-01,1.656699250916489063e-01
2.331650797586169999e-01,2.331650797586169999e-01,2.331650797586169999e-01,2.331650797586169999e-01,2.331650797586169999e-01,2.331650797586169999e-01,2.331650797586169999e-01,2.331650797586169999e-01
1.227184630308508773e-01,1.227184630308508773e-01,1.227184630308508773e-01,1.227184630308508773e-01,1.227184630308508773e-01,1.227184630308508773e-01,1.227184630308508773e-01,1.227184630308508773e-01
6.565437772150550799e-01,6.565437772150550799e-01,6.565437772150550799e-01,6.565437772150550799e-01,6.565437772150550799e-01,6.565437772150550799e-01,6.565437772150550799e-01,6.565437772150550799e-01
1.533980787885642627e-01,1.533980787885642627e-01,1.533980787885642627e-01,1.533980787885642627e-01,1.533980787885642627e-01,1.533980787885642627e-01,1.533980787885642627e-01,1.533980787885642627e-01
