1.718058482431912282e-01,1.718058482431912282e-01,1.718058482431912282e-01,1.718058482431912282e-01,1.718058482431912282e-01,1.718058482431912282e-01,1.718058482431912282e-01,1.718058482431912282e-01
2.393010029101594049e-01,2.393010029101594049e-01,2.393010029101594049e-01,2.393010029101594049e-01,2.393010029101594049e-01,2.393010029101594049e-01,2.393010029101594049e-01,2.393010029101594049e-01
1.595340019401070009e-01,1.595340019401070009e-01,1.595340019401070009e-01,1.595340019401070009e-01,1.595340019401070009e-01,1.595340019401070009e-01,1.595340019401070009e-01,1.595340019401070009e-01
6.258641614573416945e-01,6.258641614573416945e-01,6.258641614573416945e-01,6.258641614573416945e-01,6.258641614573416945e-01,6.258641614573416945e-01,6.258641614573416945e-01,6.258641614573416945e-01
1.779417713947344382e-01,1.779417713947344382e-01,1.779417713947344382e-01,1.779417713947344382e-01,1.779417713947344382e-01,1.779417713947344382e-01,1.779417713947344382e-01,1.779417713947344382e-01
2.393010029101594049e-01,2.393010029101594049e-01,2.393010029101594049e-01,2.393010029101594049e-01,2.393010029101594049e-01,2.393010029101594049e-01,2.393010029101594049e-01,2.393010029101594049e-01
1.595340019401068343e-01,1.595340019401068343e-01,1.595340019401068343e-01,1.595340019401068343e-01,1.595340019401068343e-01,1.595340019401068343e-01,1.595340019401068343e-01,1.595340019401068343e-01
6.442719309119695481e-01,6.442719309119695481e-01,6.442719309119695481e-01,6.442719309119695481e-01,6.442719309119695481e-01,6.442719309119695481e-01,6.442719309119695481e-01,6.442719309119695481e-01
1.718058482431912282e-01,1.718058482431912282e-01,1.718058482431912282e-01,1.718058482431912282e-01,1.718058482431912282e-01,1.718058482431912282e-01,1.718058482431912282e-01,1.718058482431912282e-01
