1.349903093339364368e-01,1.349903093339364368e-01,1.349903093339364368e-01,1.349903093339364368e-01,1.349903093339364368e-01,1.349903093339364368e-01,1.349903093339364368e-01,1.349903093339364368e-01
1.595340019401066123e-01,1.595340019401066123e-01,1.595340019401066123e-01,1.595340019401066123e-01,1.595340019401066123e-01,1.595340019401066123e-01,1.595340019401066123e-01,1.595340019401066123e-01
6.381360077604267822e-01,6.381360077604267822e-01,6.381360077604267822e-01,6.381360077604267822e-01,6.381360077604267822e-01,6.381360077604267822e-01,6.381360077604267822e-01,6.381360077604267822e-01
3.497476196379283864e-01,3.497476196379283864e-01,3.497476196379283864e-01,3.497476196379283864e-01,3.497476196379283864e-01,3.497476196379283864e-01,3.497476196379283864e-01,3.497476196379283864e-01
1.533980787885633468e-01,1.533980787885633468e-01,1.533980787885633468e-01,1.533980787885633468e-01,1.533980787885633468e-01,1.533980787885633468e-01,1.533980787885633468e-01,1.533980787885633468e-01
1.349903093339364368e-01,1.349903093339364368e-01,1.349903093339364368e-01,1.349903093339364368e-01,1.349903093339364368e-01,1.349903093339364368e-01,1.349903093339364368e-01,1.349903093339364368e-01
2.270291566070747891e-01,2.270291566070747891e-01,2.270291566070747891e-01,2.270291566070747891e-01,2.270291566070747891e-01,2.270291566070747891e-01,2.270291566070747891e-01,2.270291566070747891e-01
2.699806186678728737e-01,2.699806186678728737e-01,2.699806186678728737e-01,2.699806186678728737e-01,2.699806186678728737e-01,2.699806186678728737e-01,2.699806186678728737e-01,2.699806186678728737e-01
1.288543861823934211e-01,1.288543861823934211e-01,1.288543861823934211e-01,1.288543861823934211e-01,1.288543861823934211e-01,1.288543861823934211e-01,1.288543861823934211e-01,1.288543861823934211e-01
