1.840776945462776204e-01,1.840776945462776204e-01,1.840776945462776204e-01,1.840776945462776204e-01,1.840776945462776204e-01,1.840776945462776204e-01,1.840776945462776204e-01,1.840776945462776204e-01
2.331650797586173052e-01,2.331650797586173052e-01,2.331650797586173052e-01,2.331650797586173052e-01,2.331650797586173052e-01,2.331650797586173052e-01,2.331650797586173052e-01,2.331650797586173052e-01
1.411262324854780648e-01,1.411262324854780648e-01,1.411262324854780648e-01,1.411262324854780648e-01,1.411262324854780648e-01,1.411262324854780648e-01,1.411262324854780648e-01,1.411262324854780648e-01
6.135923151542570508e-01,6.135923151542570508e-01,6.135923151542570508e-01,6.135923151542570508e-01,6.135923151542570508e-01,6.135923151542570508e-01,6.135923151542570508e-01,6.135923151542570508e-01
1.472621556370210527e-01,1.472621556370210527e-01,1.472621556370210527e-01,1.472621556370210527e-01,1.472621556370210527e-01,1.472621556370210527e-01,1.472621556370210527e-01,1.472621556370210527e-01
2.270291566070747891e-01,2.270291566070747891e-01,2.270291566070747891e-01,2.270291566070747891e-01,2.270291566070747891e-01,2.270291566070747891e-01,2.270291566070747891e-01,2.270291566070747891e-01
1.595340019401068343e-01,1.595340019401068343e-01,1.595340019401068343e-01,1.595340019401068343e-01,1.595340019401068343e-01,1.595340019401068343e-01,1.595340019401068343e-01,1.595340019401068343e-01
6.442719309119692150e-01,6.442719309119692150e-01,6.442719309119692150e-01,6.442719309119692150e-01,6.442719309119692150e-01,6.442719309119692150e-01,6.442719309119692150e-01,6.442719309119692150e-01
1.840776945462776204e-01,1.840776945462776204e-01,1.840776945462776204e-01,1.840776945462776204e-01,1.840776945462776204e-01,1.840776945462776204e-01,1.840776945462776204e-01,1.840776945462776204e-01
