1.472621556370219409e-01,1.472621556370219409e-01,1.472621556370219409e-01,1.472621556370219409e-01,1.472621556370219409e-01,1.472621556370219409e-01,1.472621556370219409e-01,1.472621556370219409e-01
2.331650797586171942e-01,2.331650797586171942e-01,2.331650797586171942e-01,2.331650797586171942e-01,2.331650797586171942e-01,2.331650797586171942e-01,2.331650797586171942e-01,2.331650797586171942e-01
1.779417713947344382e-01,1.779417713947344382e-01,1.779417713947344382e-01,1.779417713947344382e-01,1.779417713947344382e-01,1.779417713947344382e-01,1.779417713947344382e-01,1.779417713947344382e-01
6.381360077604273373e-01,6.381360077604273373e-01,6.381360077604273373e-01,6.381360077604273373e-01,6.381360077604273373e-01,6.381360077604273373e-01,6.381360077604273373e-01,6.381360077604273373e-01
1.656699250916497945e-01,1.656699250916497945e-01,1.656699250916497945e-01,1.656699250916497945e-01,1.656699250916497945e-01,1.656699250916497945e-01,1.656699250916497945e-01,1.656699250916497945e-01
2.393010029101604874e-01,2.393010029101604874e-01,2.393010029101604874e-01,2.393010029101604874e-01,2.393010029101604874e-01,2.393010029101604874e-01,2.393010029101604874e-01,2.393010029101604874e-01
1.043106935762228016e-01,1.043106935762228016e-01,1.043106935762228016e-01,1.043106935762228016e-01,1.043106935762228016e-01,1.043106935762228016e-01,1.043106935762228016e-01,1.043106935762228016e-01
6.381360077604280034e-01,6.381360077604280034e-01,6.381360077604280034e-01,6.381360077604280034e-01,6.381360077604280034e-01,6.381360077604280034e-01,6.381360077604280034e-01,6.381360077604280034e-01
1.472621556370219409e-01,1.472621556370219409e-01,1.472621556370219409e-01,1.472621556370219409e-01,1.472621556370219409e-01,1.472621556370219409e-01,1.472621556370219409e-01,1.472621556370219409e-01
