1.963495408493622640e-01,1.963495408493622640e-01,1.963495408493622640e-01,1.963495408493622640e-01,1.963495408493622640e-01,1.963495408493622640e-01,1.963495408493622640e-01,1.963495408493622640e-01
1.902136176978199977e-01,1.902136176978199977e-01,1.902136176978199977e-01,1.902136176978199977e-01,1.902136176978199977e-01,1.902136176978199977e-01,1.902136176978199977e-01,1.902136176978199977e-01
5.706408530934597989e-01,5.706408530934597989e-01,5.706408530934597989e-01,5.706408530934597989e-01,5.706408530934597989e-01,5.706408530934597989e-01,5.706408530934597989e-01,5.706408530934597989e-01
2.515728492132450200e-01,2.515728492132450200e-01,2.515728492132450200e-01,2.515728492132450200e-01,2.515728492132450200e-01,2.515728492132450200e-01,2.515728492132450200e-01,2.515728492132450200e-01
1.472621556370219409e-01,1.472621556370219409e-01,1.472621556370219409e-01,1.472621556370219409e-01,1.472621556370219409e-01,1.472621556370219409e-01,1.472621556370219409e-01,1.472621556370219409e-01
1.902136176978191928e-01,1.902136176978191928e-01,1.902136176978191928e-01,1.902136176978191928e-01,1.902136176978191928e-01,1.902136176978191928e-01,1.902136176978191928e-01,1.902136176978191928e-01
2.454369260617026427e-01,2.454369260617026427e-01,2.454369260617026427e-01,2.454369260617026427e-01,2.454369260617026427e-01,2.454369260617026427e-01,2.454369260617026427e-01,2.454369260617026427e-01
2.761165418194149179e-01,2.761165418194149179e-01,2.761165418194149179e-01,2.761165418194149179e-01,2.761165418194149179e-01,2.761165418194149179e-01,2.761165418194149179e-01,2.761165418194149179e-01
1.533980787885640129e-01,1.533980787885640129e-01,1.533980787885640129e-01,1.533980787885640129e-01,1.533980787885640129e-01,1.533980787885640129e-01,1.533980787885640129e-01,1.533980787885640129e-01
