1.779417713947344382e-01,1.779417713947344382e-01,1.779417713947344382e-01,1.779417713947344382e-01,1.779417713947344382e-01,1.779417713947344382e-01,1.779417713947344382e-01,1.779417713947344382e-01
2.270291566070747891e-01,2.270291566070747891e-01,2.270291566070747891e-01,2.270291566070747891e-01,2.270291566070747891e-01,2.270291566070747891e-01,2.270291566070747891e-01,2.270291566070747891e-01
1.411262324854803130e-01,1.411262324854803130e-01,1.411262324854803130e-01,1.411262324854803130e-01,1.411262324854803130e-01,1.411262324854803130e-01,1.411262324854803130e-01,1.411262324854803130e-01
6.504078540635123140e-01,6.504078540635123140e-01,6.504078540635123140e-01,6.504078540635123140e-01,6.504078540635123140e-01,6.504078540635123140e-01,6.504078540635123140e-01,6.504078540635123140e-01
1.472621556370219409e-01,1.472621556370219409e-01,1.472621556370219409e-01,1.472621556370219409e-01,1.472621556370219409e-01,1.472621556370219409e-01,1.472621556370219409e-01,1.472621556370219409e-01
2.331650797586171942e-01,2.331650797586171942e-01,2.331650797586171942e-01,2.331650797586171942e-01,2.331650797586171942e-01,2.331650797586171942e-01,2.331650797586171942e-01,2.331650797586171942e-01
1.840776945462767877e-01,1.840776945462767877e-01,1.840776945462767877e-01,1.840776945462767877e-01,1.840776945462767877e-01,1.840776945462767877e-01,1.840776945462767877e-01,1.840776945462767877e-01
6.442719309119704363e-01,6.442719309119704363e-01,6.442719309119704363e-01,6.442719309119704363e-01,6.442719309119704363e-01,6.442719309119704363e-01,6.442719309119704363e-01,6.442719309119704363e-01
1.779417713947344382e-01,1.779417713947344382e-01,1.779417713947344382e-01,1.779417713947344382e-01,1.779417713947344382e-01,1.779417713947344382e-01,1.779417713947344382e-01,1.779417713947344382e-01
